000 000 000 000 000 000 000 000 000 100 021 100 000 000 000 000 000 000 000 000 000
000 100 100 100 100 100 100 100 100 100 000 100 100 100 100 100 100 100 100 100 000
000 100 002 002 002 002 002 002 002 002 002 002 002 002 002 002 002 002 002 100 000
000 100 003 100 002 100 002 100 100 100 002 100 100 100 002 100 002 100 003 100 000
000 100 002 002 002 100 002 002 002 100 002 100 002 002 002 100 002 002 002 100 000
000 100 002 100 100 100 002 100 002 100 002 100 002 100 002 100 100 100 002 100 000
000 100 002 002 002 002 002 100 002 002 002 002 002 100 002 002 002 002 002 100 000
000 100 002 100 002 100 100 100 100 100 002 100 100 100 100 100 002 100 002 100 000
000 100 002 002 002 002 002 002 002 002 002 002 002 002 002 002 002 002 002 100 000
000 100 100 100 002 100 002 100 100 100 100 100 100 100 002 100 002 100 100 100 000
000 000 000 100 002 100 002 002 000 000 010 000 000 002 002 100 002 100 000 000 000
100 100 100 100 002 100 100 002 100 100 001 100 100 002 100 100 002 100 100 100 100
020 000 000 000 002 000 000 002 100 011 012 013 100 002 000 000 002 000 000 000 020
100 100 100 100 002 100 100 002 100 100 100 100 100 002 100 100 002 100 100 100 100
000 100 002 002 002 000 000 002 000 000 000 000 000 002 000 000 002 002 002 100 000
000 100 002 100 002 100 100 002 100 100 100 100 100 002 100 100 002 100 002 100 000
000 100 002 002 002 100 002 002 000 000 004 000 000 002 002 100 002 002 002 100 000
000 100 100 100 002 100 002 100 100 100 100 100 100 100 002 100 002 100 100 100 000
000 000 100 002 002 002 002 002 002 002 100 002 002 002 002 002 002 002 100 000 000
000 000 100 002 100 100 002 100 100 002 100 002 100 100 002 100 100 002 100 000 000
100 100 100 002 002 002 002 002 100 002 100 002 100 002 002 002 002 002 100 100 100
100 002 002 002 100 100 100 002 100 002 100 002 100 002 100 100 100 002 002 002 100
100 003 100 002 002 002 002 002 002 002 002 002 002 002 002 002 002 002 100 003 100
100 002 002 002 100 100 100 100 100 100 000 100 100 100 100 100 100 002 002 002 100
100 100 100 100 100 000 000 000 000 100 021 100 000 000 000 000 100 100 100 100 100